3. Lig'de 13. hafta hakemleri açıklandı
Spor Toto 3. Lig'de 13. hafta maçlarını yönetecek hakemler açıklandı.Türkiye Futbol Federasyonu Merkez Hakem Kurulu'ndan yapılan açıklamaya göre, 3. Lig'de tamamı 25 Kasım Pazar günü saat 13.30'da başlayacak 13. hafta maçlarını yönetecek hakemler şunlar:

1. Grup

Fatih Karagümrük-Sandıklıspor: Mehmet Gonca
Kayseri Şekerspor-Ankara Demirspor: Hakan Tezcan
Bergama Belediyespor-Belediye Vanspor: Dilan Deniz Gökçek
İstanbulspor-Beşikdüzüspor: Serdar Sözlevi
Orhangazispor-Tekirova Belediyespor: Bahattin Şimşek
Siirtspor-Kastamonuspor: Sertaç Şaroğlu
Gölcükspor-Anadolu Üsküdar 1908: Hüseyin Yıldırım
Kırıkhanspor-Çorumspor: Gökhan Esen
Pazarspor-Diyarbakır Büyükşehir Belediyespor: Sarperbarış Saka

2. Grup

İskenderunspor 1967-Derince Belediyespor: Ümit Öztürk
Silivrispor-Sivas Dört Eylül Belediyespor: Serhat Aslan
Ümraniyespor-Menemen Belediyespor: Deniz Gültekin
Manavgat Evrensekispor-Dardanelspor: Murat Özcan
Aydınspor 1923-Gebzespor: Mustafa Aydın
Trabzon Kanuni Futbol Kulübü-Batman Petrolspor: Mehmet Emre Atasoy
Bursa Nilüferspor-Adıyamanspor: Hasan Avcı
Hacettepe-Erzincan Refahiyespor: Hüseyin Çiftsüren
Belediye Bingölspor-Kilimli Belediyespor: Mehmet Karanlık

3. Grup

Erzurum Büyükşehir Belediyespor-OYAK Renault: Muhammet Başkan
Çorum Belediyespor-Beylerbeyi: Mutlu Dalbudak
Gümüşhanespor-Sancaktepe Belediyespor: Tolga Kadaz
Darıca Gençlerbirliği-Emrespor: Zafer Koçbay
Diyarbakırspor-Elazığ Belediyespor: Deniz Kükrek
Arsinspor-Mardinspor: Cihat Çelikdağ
Kocaelispor-Kahramanmaraş Belediyespor: Sacit Keşkek
Maltepespor-Keçiörengücü: Seser Tuna
Yimpaş Yozgatspor-Altınordu: Ali Karatutlu