Djokovic, ilk turda Fransız Mathieu ile karşılaşacak
Sezonun ilk Grand Slam tenis turnuvası Avustralya Açık'ta erkeklerde ilk tur eşleşmeleri belli oldu.
Avustralya'nın Melbourne kentinde 14-27 Ocak tarihleri arasında düzenlenecek turnuvaya tek erkeklerde bir numaralı seribaşı olarak 'son şampiyon' unvanıyla katılan Sırp Novak Djokovic, yapılan kura çekimine göre ilk turda dünya sıralamasının 58 numaralı ismi Fransız Paul-Henri Mathieu ile karşılaşacak.

Avustralya Açık'ı 2004, 2006, 2007 ve 2010 yıllarında 4 kez kazanan iki numaralı seribaşı İsviçreli Roger Federer de dünya 43'üncüsü Fransız Benoit Paire ile tur mücadelesi verecek.

2010 ve 2011 finalisti 3 numaralı seri başı Andy Murray ise dünya sıralamasının 54 numaralı ismi Hollandalı Robin Haase'nin karşısına çıkacak.

Kura çekimine göre eşleşmeler şöyle oldu:

 Novak Djokovic (Sırbistan) (1) - Paul-Henri Mathieu (Fransa)
 Ryan Harrison (ABD) - Santiago Giraldo (Kolombiya)
 Arnau Brugues-Davi (İspanya) - Feliciano Lopez (İspanya)
 Viktor Troicki (Sırbistan) - Radek Stepanek (Çek Cumhuriyeti) (31)
 Sam Querrey (ABD) (20) - Daniel Munoz-De La Nava (İspanya)
 Alex Bogomolov Jr. (Rusya) - Brian Baker (ABD)
 Tobias Kamke (Almanya) - Flavio Cipolla (İtalya)
 Cedrik-Marcel Stebe (Almanya) - Stanislas Wawrinka (İsviçre) (15)
 Juan Monaco (Arjantin) (11) - Andrey Kuznetsov (Rusya)
 Kevin Anderson (Güney Afrika) - Paolo Lorenzi (İtalya)
 Xavier Malisse (Belçika) - Pablo Andujar (İspanya)
 David Goffin (Belçika) - Fernando Verdasco (İspanya) (22)
 Jurgen Melzer (Avusturya) (26) - Mikhail Kukushkin (Kazakistan)
 Fabio Fognini (İtalya) - Roberto Bautista Agut (İspanya)
 Julian Reister (Almanya) - Guillaume Rufin (Fransa)
 Michael Russell (ABD) - Tomas Berdych (Çek Cumhuriyeti) (5)
 David Ferrer (İspanya) (4) - Olivier Rochus (Belçika)
 Ivo Karlovic (Hırvatistan) - Tim Smyczek (ABD)
 John Millman (Avustralya) - Tatsuma Ito (Japonya)
 Albert Ramos (İspanya) - Marcos Baghdatis (Kıbrıs Rum Kesimi) (28)
 Mikhail Youzhny (Rusya) (23) - Matthew Ebden (Avustralya)
 Evgeny Donskoy (Rusya) - Adrian Ungur (Romanya)
 Maxime Authom (Belçika) - Carlos Berlocq (Arjantin)
 Victor Hanescu (Romanya) - Kei Nishikori (Japonya) (16)
 Nicolas Almagro (İspanya) (10) - Steve Johnson (ABD)
 Daniel Gimeno-Traver (İspanya) - Lukasz Kubot (Polonya)
 Bjorn Phau (Almanya) - Somdev Devvarman (Hindistan)
 Simone Bolelli (İtalya) - Jerzy Janowicz (Polonya) (24)
 Julien Benneteau (Fransa) (32) - Grigor Dimitrov (Bulgaristan)
 Edouard Roger-Vasselin (Fransa) - Ruben Bemelmans (Belçika)
 Lukas Lacko (Slovakya) - Gilles Muller (Lüksemburg)
 Lleyton Hewitt (Avustralya) - Janko Tipsarevic (Sırbistan) (8)
 Juan Martin Del Potro (Arjantin) (6) - Adrian Mannarino (Fransa)
 Aljaz Bedene (Slovenya) - Benjamin Becker (Almanya)
 Jeremy Chardy (Fransa) - Adrian Menendez-Maceiras (İspanya)
 Grega Zemlja (Slovenya) - Marcel Granollers (İspanya) (30)
 Andreas Seppi (İtalya) (21) - Horacio Zeballos (Arjantin)
 Igor Sijsling (Hollanda) - Denis Istomin (Özbekistan)
 Guillermo Garcia-Lopez (İspanya) - Rajeev Ram (ABD)
 Marinko Matosevic (Avustralya) - Marin Cilic (Hırvatistan) (12)
 Gilles Simon (Fransa) (14) - Filippo Volandri (İtalya)
 Tommy Robredo (İspanya) - Jesse Levine (Kanada)
 Yen-Hsun Lu (Tayvan) - Ruben Ramirez Hidalgo (İspanya)
 Gael Monfils (Fransa) - Alexandr Dolgopolov (Ukrayna) (18)
 Florian Mayer (Almanya) (25) - Rhyne Williams (ABD)
 Ricardas Berankis (Litvanya) - Sergiy Stakhovsky (Ukrayna)
 Joao Sousa (Portekiz) - John-Patrick Smith (Avustralya)
 Robin Haase (Hollanda) - Andy Murray (Büyük Britanya) (3)
 Jo-Wilfried Tsonga (Fransa) (7) - Michael Llodra (Fransa)
 Go Soeda (Japonya) - Luke Saville (Avustralya)
 James Duckworth (Avustralya) - Benjamin Mitchell (Avustralya)
 Blaz Kavcic (Slovenya) - Thomaz Bellucci (Brezilya) (29)
 Tommy Haas (Almanya) (19) - Jarkko Nieminen (Finlandiya)
 Ivan Dodig (Hırvatistan) - Di Wu (Çin)
 Josselin Ouanna (Fransa) - Alejandro Falla (Kolombiya)
 Albert Montanes (İspanya) - Richard Gasquet (Fransa) (9)
 Milos Raonic (Kanada) (13) - Jan Hajek (Çek Cumhuriyeti)
 Jamie Baker (Büyük Britanya) - Lukas Rosol (Çek Cumhuriyeti)
 Amir Weintraub (İsrail) - Guido Pella (Arjantin)
 Steve Darcis (Belçika) - Philipp Kohlschreiber (Almanya) (17)
 Martin Klizan (Slovakya) (27) - Daniel Brands (Almanya)
Bernard Tomic (Avustralya) - Leonardo Mayer (Arjantin)
Dudi Sela (İsrail) - Nikolay Davydenko (Rusya)
Benoit Paire (Fransa) - Roger Federer (İsviçre) (2)