Avustralya'da kadınlar ilk tur eşleşmeleri
Sezonun ilk Grand Slam turnuvası Avustralya Açık'ta ilk tur eşleşmeleri belli oldu.
Kariyerindeki ilk Grand Slam zaferini geçen yıl Avustralya Açık'ta kazanan ve şampiyon unvanını korumak için Melbourne'ye gelen Belaruslu Victoria Azarenka, yapılan kura çekimine göre ilk turda dünya sıralamasının 54 numaralı ismi Romanya'dan Monica Niculescu ile eşleşti. 2008 Avustralya Açık şampiyonu 2 numaralı seri başı Rus Maria Sharapova, dünya 105'incisi vatandaşı Olga Puchkova ile ikinci tura yükselme mücadelesi verecek. Avustralya Açık'ı 2003, 2005, 2007, 2009 ve 2010 yıllarında 5 kez kazanan 3 numaralı seri başı ABD'li Serena Williams ise dünyanın 108 numarası Edina Gallovits-Hall karşılaşacak.
 
İlk turda Azarenka gibi Romen bir raketle eşleşen Williams, ayrıca Azarenka ile ana tablonun aynı bölümünde yer alıyor. Bu, dünyanın 1 ile 3 numarasının karşılaşmasının, muhtemel bir yarı final eşleşmesinde izlenebileceği anlamına geliyor. Avustralya Açık Tenis Turnuvası, 14-27 Ocak tarihleri arasında Avustralya'nın Melbourne kentinde yapılacak.
 
Kura çekimine göre eşleşmeler şöyle oldu:
Victoria Azarenka (Belarus) (1) - Monica Niculescu (Romanya)
Eleni Daniilidou (Yunanistan) - Karolina Pliskova (Çek Cumhuriyeti)
Luksika Kumkhum (Tayland) - Sofia Arvidsson (İsveç)
Jamie Hampton (ABD) - Urszula Radwanska (Polonya) (31)
Varvara Lepchenko (ABD) (21) - Polona Hercog (Slovenya)
Caroline Garcia (Fransa) - Elena Vesnina (Rusya)
Mathilde Johansson (Fransa) - Akgül Amanmuradova (Özbekistan)
Silvia Soler-Espinosa (İspanya) - Roberta Vinci (İtalya) (16)
Caroline Wozniacki (Danimarka) (10) - Sabine Lisicki (Almanya)
Andrea Hlavackova (Çek Cumhuriyeti) - Donna Vekic (Hırvatistan)
Daria Gavrilova (Rusya) - Lauren Davis (ABD)
Lesia Tsurenko (Ukrayna) - Anastasia Pavlyuchenkova (Rusya) (24)
Su-Wei Hsieh (Tayvan) (26) - Lara Arruabarrena-Vecino (İspanya)
Svetlana Kuznetsova (Rusya) - Lourdes Dominguez Lino (İspanya)
Yulia Putintseva (Kazakistan) - Christina McHale (ABD)
Carla Suarez Navarro (İspanya) - Sara Errani (İtalya) (7)
Serena Williams (ABD) (3) - Edina Gallovits-Hall (Romanya)
Magdalena Rybarikova (Slovakya) - Garbine Muguruza (İspanya)
Ayumi Morita (Japonya) - Anna Tatishvili (Gürcistan)
Annika Beck (Almanya) - Yaroslava Shvedova (Kazakistan) (28)
Yanina Wickmayer (Belçika) (20) - Jarmila Gajdosova (Avustralya)
Greta Arn (Macaristan) - Jana Cepelova (Slovakya)
Rebecca Marino (Kanada) - Shuai Peng (Çin)
Vania King (ABD) - Maria Kirilenko (Rusya) (14)
Nadia Petrova (Rusya) (12) - Kimiko Date-Krumm (Japonya)
Shahar Peer (İsrail) - Alexandra Panova (Rusya)
Maria-Teresa Torro-Flor (İspanya) - Bojana Jovanovski (Sırbistan)
Mirjana Lucic-Baroni (Hırvatistan) - Lucie Safarova (Çek Cumhuriyeti) (17)
Sloane Stephens (ABD) (29) - Simona Halep (Romanya)
Kristina Mladenovic (Fransa) - Timea Babos (Macaristan)
Melanie Oudin (ABD) - Laura Robson (Büyük Britanya)
Francesca Schiavone (İtalya) - Petra Kvitova (Çek Cumhuriyeti) (8)
Na Li (Çin) (6) - Sesil Karatantcheva (Kazakistan)
Pauline Parmentier (Fransa) - Olga Govortsova (Belarus)
Kristyna Pliskova (Çek Cumhuriyeti) - Sacha Jones (Avustralya)
Coco Vandeweghe (ABD) - Sorana Cirstea (Romanya) (27)
Julia Goerges (Almanya) (18) - Vera Dushevina (Rusya)
Romina Oprandi (İsviçre) - Tsvetana Pironkova (Bulgaristan)
Yuxuan Zhang (Çin) - Jie Zheng (Çin)
Kai-Chen Chang (Tayvan) - Samantha Stosur (Avustralya) (9)
Ana Ivanovic (Sırbistan) (13) - Melinda Czink (Macaristan)
Yung-Jan Chan (Tayvan) - Daniela Hantuchova (Slovakya)
Maria Joao Koehler (Portekiz) - Karin Knapp (İtalya)
Johanna Larsson (İsveç) - Jelena Jankovic (Sırbistan) (22)
Mona Barthel (Almanya) (32) - Ksenia Pervak (Kazakistan)
Heather Watson (Büyük Britanya) - Alexandra Cadantu (Romanya)
Irina-Camelia Begu (Romanya) - Arantxa Rus (Hollanda)
Bojana Bobusic (Avustralya) - Agnieszka Radwanska (Polonya) (4)
Angelique Kerber (Almanya) (5) - Elina Svitolina (Ukrayna)
Lucie Hradecka (Çek Cumhuriyeti) - Kiki Bertens (Hollanda)
Casey Dellacqua (Avustralya) - Madison Keys (ABD)
Stefanie Voegele (İsviçre) - Tamira Paszek (Avusturya) (30)
Ekaterina Makarova (Rusya) (19) - Michelle Larcher De Brito (Portekiz)
Camila Giorgi (İtalya) - Stephanie Foretz Gacon (Fransa)
Vesna Dolonc (Sırbistan) - Olivia Rogowska (Avustralya)
Anabel Medina Garrigues (İspanya) - Marion Bartoli (Fransa) (11)
Dominika Cibulkova (Slovakya) (15) - Ashleigh Barty (Avustralya)
Mandy Minella (Lüksemburg) - Valeria Savinykh (Rusya)
Kirsten Flipkens (Belçika) - Nina Bratchikova (Rusya)
Chanelle Scheepers (Güney Afrika) - Klara Zakopalova (Çek Cumhuriyeti) (23)
Venus Williams (ABD) (25) - Galina Voskoboeva (Kazakistan)
Alize Cornet (Fransa) - Marina Erakovic (Yeni Zelanda)
Petra Martic (Hırvatistan) - Misaki Doi (Japonya)
Olga Puchkova (Rusya) - Maria Sharapova (Rusya) (2)