2013'te dövizle borçlanmaya dikkat yatırımcıya sürpriz kazançlar gelebilir
İMKB-30 şirketlerinin kuruluş tarihlerine göre astroloji haritasını çıkartan Nuray Sayarı, Türkiye'nin devlerini masaya yatırdı. Turkcell'i sürpriz kazançlar, Türk Telekom'u bolluk, Garanti'yi ise yeni yeni fırsatlar bekliyor...
 Aylin LÖLE / İSTANBUL
 Ünlü Astrolog Nuray Sayarı AKŞAM Ekonomi'ye özel İMKB-30 şirketlerinin burç yorumlarını yaptı. Sayarı, 2013'te arınma, ilerleme ve birileri krizler yaşarken bir başkalarının da büyük fırsatlara sahip olabileceğine dikkat çekerek, 'Sonuç odaklı olanlar için zorlanmalar söz konusu. Dövizle yatırım yapacak olan yatırımların dikkatli olmasını isterim' diyor. Peki İMKB-30'daki şirketleri 2013'te ne bekliyor? Sayarı'nın analizine göre Turkcell yatırımcılarını sürpriz kazançlar, İş Bankası'nı yıl boyunca başarı, Akbank'ın sürpriz fırsatlar, Türk Telekom'u da bereketli bir yıl bekliyor. İşte İMKB-30 şirketlerinin kurulum tarihlerine göre astroloji haritası...
 Sürpriz 'Garanti...'
 - EMLAK KONUT GYO (OĞLAK BURCU): Kurulum tarihi ile kalıcı fakat yılın ilk altı aylık süreci zorlanmalar söz konusu. Daha sonra amaçlanılan kazançlar için bekleyici olmak gerekebilir. Özellikle 19.10.2013 yılın son Güneş tutulması Koç burcunda büyük fırsatlar getirebilir. 
 - ERDEMİR (BOĞA BURCU): Kurulum anı başarıyı garantiliyor. Boğa burcu  başarıyı 5-10 Mayıs 2013'e kadar zorlayacak ve daha sonra kazanma ilerleme daha ön planda olması olası.  
 - GARANTİ (BOĞA BURCU): Garanti Bankası kurulum anı uyum ve kazanç anına denk gelmekte. Burcu Boğa geleceğinde sabit başarı için sürprizlerle dolu bir yıl yaşanırken beklenmedik yükselişler de olası.  
 - HALKBANK (İKİZLER BURCU): Kurulum anı güçlü bir sürece denk gelmekte kalıcı başarıyı da yaşatmakta. Hayal gibi kazançlar yaşanabilir.
 Krizlerin fırsata döndüğü bir yıl
 - MİGROS: (ASLAN BURCU): Kurulum anı kazançlı ve liderlik anına denk geliyor. Kazançlı ve başarılı bir yıl geçirmesi olası olurken büyük fırsatlar ve dönüşümler de yaşanabilir. 
 - PETKİM (KOÇ BURCU): Burcu Koç, büyük zorlukları aşıp yılın ilk altı ayında çok kazandırması olası. 2013'te yatırımcılar hayallerine ulaşabilirler. 
 - ŞİŞECAM (AKREP BURCU): Kurulum zamanı biraz belirsizlikler getirebilir. Burcu akrep zorlayıcı yatırımlar çok fazla olsa da 2013 yatırımcılarına krizleri fırsatlara dönüştürme etkisi de yaşatabilir. 
 - TURKCELL (TERAZİ BURCU): Kurulum anı zorluk ve mücadeleye denk gelse de kazanmakta. Sürprizlere açık olunması gerekiyor.
 25 Mayıs'ta Yay'a dikkat edin
 - İHLAS HOLDİNG (OĞLAK BURCU): Zorlayıcı bir sürece girebilir. 
 - İŞ BANKASI (C) (BAŞAK BURCU): Kurulum anı başarı hedefletiyor. Kazancın ön planda olacağı bir yıl. 
 - KOÇ HOLDİNG (YAY BURCU): Yay burcu zorlayıcı bir süreç de yatırımcıların 25.5.2013'de Yay burcunda gerçekleşecek ay tutulmasında  3 ay dikkatli olması gerekebilir. Ay tutulması gerilim getirebilir. 
 - KOZA MADENCİLİK (YAY BURCU): Kurulum anı değişimlerin her an olasılığına isabet etmekte. Koza Madencilik Yay burcu büyük fırsatlara sahip ve kazançlı ama çok da riskli bir yıla giriyor. Özellikle yılın ilk 6 aylık süreci zorlanmalar alabilir.
 Beklenmedik kazançlara kapı açın
 - ENKA (OĞLAK BURCU): Jüpiter'in Oğlak burcunda olduğu yıl kurulmuş. Bolluk ve bereketi temsil ediyor. 
 - İPEK ENERJİ (OĞLAK BURCU): 2013 yılı dönüşüm ve değişim yılı olacak. 
 - KOZA ALTIN (BAŞAK BURCU): Her an sürpriz yapabilecek bir enerjiye sahip. 2013'te endişeler fazla olsa da, kazandırma olasılıkları da an ve an çok fazla.
 - NETAŞ (KOÇ BURCU): Yıl boyu Koç burcunda seyrine devam eden Uranüs, yılın ilk sekiz ayında, beklenmedik kazançlar yaşatabilir yatırımcılarına. 
 - TOFAŞ (OĞLAK BURCU): Kurulum anının en büyük etkisi, başarıda sabitlik, 2013 yılında yatırımcılarına 28 Nisan'dan sonra kazançlar yaşatabilir.
 Akbank'ta büyük fırsatlar var
 - TÜRK TRAKTÖR (ASLAN BURCU): Kurulum anındaki enerjisi beklenmedik anlarda kazanç, 2013 yılında yatırımcılara bekleterek kazançlar sunabilir. İlk 5 ayda risklere dikkat. 
 - TÜPRAŞ (AKREP BURCU): Yatırımcıların plansız hareket etmemesi gerek. Nisan ve mayısta risklere karşı dikkat. 
 - AKBANK (OĞLAK BURCU): Kurulum anı yönetici tek olma ve liderlik ve vazgeçilmez enerjisine sahip. Kazanma ve kazandırma yönünde büyük fırsatların olacağı bir yıl 2013. 
 - BİM (İKİZLER BURCU): Dönüşümler ve değişimler yaşatma zamanı, 2013 yatırımcılar için çok net bir yıl olacak. 
 - KARDEMİR-D (BALIK BURCU): Bittim tükendim diyen yatırımcılarına küllerinden doğma enerjisini yıl boyu yaşatabilir.